11111111111
11110P01111
1C000C000C1
10111111101
10000C00001
10111111101
1C0000000C1
11111011111
1E000C000E1
11111111111
